brand,spv,pos,neg,neu,total
atomberg,0.5032679738562091,77,37,39,153
bajaj,0.14285714285714285,1,6,0,7
crompton,0.6176470588235294,21,13,0,34
havells,0.5294117647058824,27,4,20,51
lg,0.7272727272727273,8,0,3,11
orient electric,1.0,2,0,0,2
panasonic,1.0,4,0,0,4
philips,0.0,0,4,0,4
polycab,0.75,12,0,4,16
superfan,0.23529411764705882,4,8,5,17
usha,1.0,13,0,0,13
v-guard,1.0,4,0,0,4
